A2_atividade1
Clarefied - Esclarecido
Perpetraded - executado
underlying - basica
reasoning - raciocinio
chores - tarefas
Accordingly - Assim/consequentemente
Bunch - grupo
Self-contained - independente
Guidelines - Diretrizes/norma/regra
Tackle - Enfrentar
Conceivable - viável
Ought - deve
Thus logo/assim/portanto
Likewise - da mesma forma/além disso/também
Attempts - tentativas/tenta
Moreover - além disso
Approach - abordagem/metodo
Strikes - atinge/bate
Unavelled - desvendado
Afterwards - depois/posteriormente
strightforward - direto/simples
unpredictable - imprevisivel
Greedy - guloso
Towards - perante
accomplished - concluido/concretizado
Sudden - repentino/subito/brusco
Deems - considere/julgue
steadily - continuamente/progressivamente
attempting - tentando
neglect - descaso/descuido/negligencia
fulfil - cumprir/satisfazer/preencher

A2_atividade2
boundaries -fronteiras/barreiras/limites
nonprofit - sem fins lucrativos
regardless - independentemente/apesar
income - renda
wealth - riqueza
outreach - divuldação/alcance
